00000000000000000000000000000000000000000000000000000000000000000000000000000000000000
00000000000000000000000000000000000000000000000000000000000000000000000000000002222222
00000000000000000000000000000000000000000000000000000000000000000000000000000001111111
00000000000000000000000000000000000000000000000000002222222000000000000000000000011111
00000000000000000000000000000000000000000000000000001111111000000000000000000000001111
00000000000000000000000000000000000000000000000000000000000000000000000000000002222111
22222222222220000000000000000000000000000000000000000000000000000000000000000001111111
11111111111110000000000000000000000000000000000000000000000000000000000000000000000000
11111111100000000000000000000000000000000000000000000000000000000002222220000000000000
11111111100000000000000000000000000000000000002222000000000000000000000000000000000000
11100000000000000000000000000000000000000000000000000000000000000000000000000000000000
11000000000000000000000000002222222222222220000000000000000000000000000000000000000000
10000000000000000000000000021111111111111100000000000000000000000000000000000000000000
00000000000000000000000000000000000000000000000000000000000000000000000000000000000000
00000000000000000222222220000000000000000000000000000000000000000000000000000000000000
00000000000000000111111110000000000000000000000000000000000000000000000000000000000000
00000000022222222111111112222222222222222222222222222222222222222222222222222222222222
22222222211111111111111111111111111111111111111111111111111111111111111111111111111111
11111111111111111111111111111111111111111111111111111111111111111111111111111111111111
11111111111111111111111111111111111111111111111111111111111111111111111111111111111111
11111111111111111111111111111111111111111111111111111111111111111111111111111111111111